#####
#SXX#
###X#
#  E#
#####
